9 8
########
###   ##
#XPS  ##
### SX##
#X##S ##
# # X ##
#S ZSSX#
#   X  #
########
