10 13
#############
###  ########
#  S PXXX#  #
#  S #S#ZX  #
### ##XXX#  #
### # SSS  ##
##  # # ## ##
##         ##
##  #########
#############
