12 10
##########
###### P##
# S      #
# # ## # #
# #  #S# #
# #S # # #
# #  # S #
# ## # ###
#  XXXX ##
#### ## ##
####    ##
##########
