9 9
#########
##  #####
##PS#####
#   #####
#   SXXX#
###     #
#####S ##
#####  ##
#########
