12 11
###########
#  #   ####
#  S  #####
# S## #####
## #X ##  #
## #X   S #
## #X ##  #
## #X### ##
##P   ##  #
### S     #
########  #
###########


