12 11
###########
# X X #####
#    X#####
#  #  #####
## # ######
## # ######
##S  PS   #
##   ###S #
##  X     #
##S #######
##  #######
###########
