11 19
###################
#####   ###########
#####S  ###########
#####  S###########
###  S S ##########
### # ## ##########
#   # ## #####  XX#
# S  S   P      XX#
##### ### # ##  XX#
#####     #########
###################
